AwesomeAngel57 	banana 	J.Pasek@ugrad.unsw.edu.au
AwesomeAngel71 	broncos 	Ashanti@ugrad.unsw.edu.au
AwesomeAngel82 	mark 	L.M.Presley@ugrad.unsw.edu.au
AwesomeBabe30 	acaras 	princess800@dispostable.com
AwesomeBaby93 	japan 	K.Loken@ugrad.unsw.edu.au
AwesomeBadboy17 	fender 	L.V.Trier@ugrad.unsw.edu.au
AwesomeCat10 acaras princess8@dispostable.com
AwesomeGal77 	1111 	D.Messing@ugrad.unsw.edu.au
AwesomeGeek73 	ou812 	A.Banderas@ugrad.unsw.edu.au
AwesomeGenius60 	voodoo 	H.Fleiss@ugrad.unsw.edu.au
AwesomeGirl11 	trustno1 	M.Bellucci@ugrad.unsw.edu.au
AwesomeGuy91 	magnum 	M.A.Barrera@ugrad.unsw.edu.au
AwesomeKitten12 	florida 	A.Bynes@ugrad.unsw.edu.au
AwesomeLover56 	teens 	L.Sagnier@ugrad.unsw.edu.au
AwesomeLover76 	testing 	B.Fonda@ugrad.unsw.edu.au
AwesomeNerd12 	12345678 	J.Moore@ugrad.unsw.edu.au
AwesomeNinja22 	kelly 	I.Thorpe@ugrad.unsw.edu.au
AwesomeStar26 	fender 	D.Moore@ugrad.unsw.edu.au
AwesomeStar87 	freddy 	B.Darvish@ugrad.unsw.edu.au
AwesomeSurfer30 	xxxx 	J.Swofford@ugrad.unsw.edu.au
AwesomeThinker58 	guitar 	B.Johnson@ugrad.unsw.edu.au
AwesomeWoman76 	florida 	K.Winslet@ugrad.unsw.edu.au
BrainyAnimal93 	cameron 	T.Falise@ugrad.unsw.edu.au
BrainyBoy69 	please 	J.Gruden@ugrad.unsw.edu.au
BrainyBoy73 	hockey 	L.Gutierrez@ugrad.unsw.edu.au
BrainyGenius46 	apollo 	M.Mullally@ugrad.unsw.edu.au
BrainyGirl98 	hammer 	N.Vardalos@ugrad.unsw.edu.au
BrainyGuy54 	flower 	N.D.Frutos@ugrad.unsw.edu.au
BrainyLover84 	captain 	S.Ganguly@ugrad.unsw.edu.au
BrainyLover92 	chris 	T.Ridge@ugrad.unsw.edu.au
BrainyMan52 	buster 	F.Inzaghi@ugrad.unsw.edu.au
BrainyNerd47 	hannah 	M.Doherty@ugrad.unsw.edu.au
BrainyPrincess94 	pepper 	C.T.Whitman@ugrad.unsw.edu.au
BrainyPuppy21 	david 	K.Kharrazi@ugrad.unsw.edu.au
BrainyPuppy25 	hockey 	K.Reeves@ugrad.unsw.edu.au
BrainyTiger33 	shannon 	R.Romano@ugrad.unsw.edu.au
BrainyTiger48 	juice 	J.Edwards@ugrad.unsw.edu.au
BrainyTiger94 	steven 	C.Crawford@ugrad.unsw.edu.au
ChocolateBadboy41 	enter 	A.Sandler@ugrad.unsw.edu.au
ChocolateChick65 	oliver 	S.Crow@ugrad.unsw.edu.au
ChocolateDude57 	viking 	M.Weir@ugrad.unsw.edu.au
ChocolateDude89 	cool 	R.Federer@ugrad.unsw.edu.au
ChocolateGenius46 	arsenal 	O.Fedorova@ugrad.unsw.edu.au
ChocolateGenius97 	compaq 	L.Figo@ugrad.unsw.edu.au
ChocolateKitten48 	member 	H.Klum@ugrad.unsw.edu.au
ChocolateKitten88 	oliver 	M.Chrousala@ugrad.unsw.edu.au
ChocolateLover52 	jackie 	M.S.A.Valenzuela@ugrad.unsw.edu.au
ChocolateLover92 	monica 	J.Aniston@ugrad.unsw.edu.au
ChocolateMan91 	apples 	E.Hawke@ugrad.unsw.edu.au
ChocolateNerd75 	donald 	D.Nalbandian@ugrad.unsw.edu.au
ChocolatePrincess16 	rabbit 	D.Versace@ugrad.unsw.edu.au
ChocolatePuppy67 	midnight 	G.Clooney@ugrad.unsw.edu.au
ChocolateThinker53 	peter 	M.Steenburgen@ugrad.unsw.edu.au
ChocolateWoman18 	steelers 	E.Harold@ugrad.unsw.edu.au
CoolAnimal39 	mike 	A.Chalabi@ugrad.unsw.edu.au
CoolAnimal47 	gators 	P.Bremer@ugrad.unsw.edu.au
CoolAnimal66 	gregory 	R.Carlos@ugrad.unsw.edu.au
CoolAnimal97 	mustang 	S.V.D.Mello@ugrad.unsw.edu.au
CoolBadboy34 	cookie 	L.G.Macchi@ugrad.unsw.edu.au
CoolBoy15 	redwings 	M.Schumacher@ugrad.unsw.edu.au
CoolGeek36 	super 	C.Longo@ugrad.unsw.edu.au
CoolGeek62 	steve 	A.Losyukov@ugrad.unsw.edu.au
CoolGenius74 	6969 	G.Coria@ugrad.unsw.edu.au
CoolGuy66 	casper 	J.OBrien@ugrad.unsw.edu.au
CoolKitten14 	scooby 	S.M.Gellar@ugrad.unsw.edu.au
CoolKitten24 	zxcvbnm 	G.Paltrow@ugrad.unsw.edu.au
CoolKitten55 	toyota 	V.Williams@ugrad.unsw.edu.au
CoolLover73 	dennis 	F.Castro@ugrad.unsw.edu.au
CoolLover95 	696969 	R.Zellweger@ugrad.unsw.edu.au
CoolMan37 	buster 	F.Trillo@ugrad.unsw.edu.au
CoolPrincess80 nicholas A.Akin@ugrad.unsw.edu.au
CoolSurfer60 	sexy 	B.Clinton@ugrad.unsw.edu.au
CoolTiger31 	teresa 	S.Channing@ugrad.unsw.edu.au
CoolTiger38 	jessica 	R.L.N.de.Lima@ugrad.unsw.edu.au
CoolTiger51 	112233 	O.D.L.Hoya@ugrad.unsw.edu.au
CoolWoman28 	iwantu 	P.Cruz@ugrad.unsw.edu.au
CrazyAnimal18 	joshua 	R.Virenque@ugrad.unsw.edu.au
CrazyBaby22 	iloveyou 	C.Dion@ugrad.unsw.edu.au
CrazyDude68 	232323 	R.Simmons@ugrad.unsw.edu.au
CrazyGeek14 	danielle 	S.McClellan@ugrad.unsw.edu.au
CrazyGenius52 	mustang 	E.Hurley@ugrad.unsw.edu.au
CrazyNinja82 	doggie 	K.A.II@ugrad.unsw.edu.au
CrazyPuppy84 	123123 	G.Hackett@ugrad.unsw.edu.au
CrazyThinker53 	yankee 	U.Thurman@ugrad.unsw.edu.au
CreativeGal98 	shit 	S.Field@ugrad.unsw.edu.au
CreativeGeek61 	george 	A.Baldwin@ugrad.unsw.edu.au
CreativeGenius46 	tigers 	D.Schroeder@ugrad.unsw.edu.au
CreativeGuy20 	fishing 	D.E.Jr@ugrad.unsw.edu.au
CreativeGuy87 	tigger 	C.Ancelotti@ugrad.unsw.edu.au
CreativeLover63 	leather 	L.Bush@ugrad.unsw.edu.au
CreativeMan84 	orange 	J.M.Marquez@ugrad.unsw.edu.au
CreativeNerd54 	blondes 	V.Klitschko@ugrad.unsw.edu.au
CreativeNinja66 	green 	D.Radcliffe@ugrad.unsw.edu.au
CreativeStar68 	nascar 	B.Hope@ugrad.unsw.edu.au
CreativeStar76 	jasmine 	D.Reynolds@ugrad.unsw.edu.au
CreativeTiger59 	ferrari 	M.Myers@ugrad.unsw.edu.au
CreativeTiger83 	andrew 	B.Streisand@ugrad.unsw.edu.au
CreativeWoman60 	blondes 	C.Zeta-Jones@ugrad.unsw.edu.au
CupcakeAnimal79 	xavier 	B.Callahan@ugrad.unsw.edu.au
CupcakeAnimal92 	xavier 	M.Philippoussis@ugrad.unsw.edu.au
CupcakeBadboy74 	rangers 	D.Beckham@ugrad.unsw.edu.au
CupcakeChick55 	peanut 	J.Gerberding@ugrad.unsw.edu.au
CupcakeGenius88 	yamaha 	M.Rios@ugrad.unsw.edu.au
CupcakeGenius89 	golfer 	R.Myers@ugrad.unsw.edu.au
CupcakeGirl43 	samson 	E.Zylberstein@ugrad.unsw.edu.au
CupcakeKitten62 	oliver 	R.Wilson@ugrad.unsw.edu.au
CupcakeNerd87 	james 	K.Warner@ugrad.unsw.edu.au
CupcakeNinja29 	nicholas 	A.Uribe@ugrad.unsw.edu.au
CupcakeSurfer16 	broncos 	J.Capriati@ugrad.unsw.edu.au
CupcakeSurfer37 	bond007 	J.Kerry@ugrad.unsw.edu.au
CupcakeTiger61 	apple 	P.Brosnan@ugrad.unsw.edu.au
CuteAnimal30 	fishing 	M.Powell@ugrad.unsw.edu.au
CuteDude11 	lover 	W.Ferreira@ugrad.unsw.edu.au
CuteDude60 	prince 	G.Carter@ugrad.unsw.edu.au
CuteDude95 	cookie 	H.Karzai@ugrad.unsw.edu.au
CuteGal13 	winter 	J.Lopez@ugrad.unsw.edu.au
CuteGeek78 	diablo 	N.Bush@ugrad.unsw.edu.au
CuteGenius13 	happy 	C.M.Pruneda@ugrad.unsw.edu.au
CuteGenius15 	scooby 	P.Labelle@ugrad.unsw.edu.au
CuteLover30 	gators 	J.Ullrich@ugrad.unsw.edu.au
CuteMan46 	winter 	T.Woods@ugrad.unsw.edu.au
CuteNinja61 	daniel 	T.Hanks@ugrad.unsw.edu.au
CuteStar84 	1313 	B.Curtis@ugrad.unsw.edu.au
CuteWoman73 	nicole 	F.Dunaway@ugrad.unsw.edu.au
CuteWoman83 	mine 	P.Anderson@ugrad.unsw.edu.au
DesperateBaby26 	tiger 	A.Vega@ugrad.unsw.edu.au
DesperateBaby36 	andrew 	D.Krall@ugrad.unsw.edu.au
DesperateGenius16 	jack 	C.Deneuve@ugrad.unsw.edu.au
DesperateGuy50 	silver 	C.Gomes@ugrad.unsw.edu.au
DesperateKitten80 	paris 	L.Minnelli@ugrad.unsw.edu.au
DesperateLover67 	mickey 	Juanes@ugrad.unsw.edu.au
DesperateNinja48 	power 	J.Chirac@ugrad.unsw.edu.au
DesperateNinja82 	iceman 	L.E.D.Bautista@ugrad.unsw.edu.au
DesperatePuppy83 	whatever 	A.Mauresmo@ugrad.unsw.edu.au
DesperatePuppy92 	giants 	A.Gul@ugrad.unsw.edu.au
DesperateThinker29 	florida 	J.Koizumi@ugrad.unsw.edu.au
DorkyAngel70 	beer 	K.Yang-sook@ugrad.unsw.edu.au
DorkyAnimal47 	richard 	L.Armstrong@ugrad.unsw.edu.au
DorkyChick85 	great 	C.Baumgartner@ugrad.unsw.edu.au
DorkyGal56 	carter 	M.Streep@ugrad.unsw.edu.au
DorkyGeek53 	summer 	B.Spears@ugrad.unsw.edu.au
DorkyKitten30 	smokey 	C.Bolocco@ugrad.unsw.edu.au
DorkyKitten83 	hunting 	K.Harris@ugrad.unsw.edu.au
DorkyMan52 	peaches 	J.Fischer@ugrad.unsw.edu.au
DorkyMan78 	king 	E.Morales@ugrad.unsw.edu.au
DorkyNerd13 	charlie 	M.McBride@ugrad.unsw.edu.au
DorkyPrincess81 	master 	N.Kidman@ugrad.unsw.edu.au
DorkyPuppy13 	corvette 	J.Stockton@ugrad.unsw.edu.au
DorkyPuppy15 	spider 	M.Dillon@ugrad.unsw.edu.au
DorkyPuppy24 	dave 	Zico@ugrad.unsw.edu.au
DorkyPuppy39 	5150 	W.Gretzky@ugrad.unsw.edu.au
DorkyStar32 	steven 	N.Watts@ugrad.unsw.edu.au
DorkyThinker45 	cheese 	S.Williams@ugrad.unsw.edu.au
DreamAnimal98 	2000 	G.Marco@ugrad.unsw.edu.au
DreamBadboy51 	aaaa 	Jean-P.Raffarin@ugrad.unsw.edu.au
DreamBoy30 	nathan 	S.Stallone@ugrad.unsw.edu.au
DreamChick35 	forever 	E.Smart@ugrad.unsw.edu.au
DreamDude37 	srinivas 	F.Solich@ugrad.unsw.edu.au
DreamGal95 	movie 	R.C.Revels@ugrad.unsw.edu.au
DreamLover27 	beer 	C.Aguilera@ugrad.unsw.edu.au
DreamMan54 	william 	R.Williams@ugrad.unsw.edu.au
DreamNerd35 	sophie 	R.Romijn-Stamos@ugrad.unsw.edu.au
DreamPuppy33 	muffin 	M.Kasyanov@ugrad.unsw.edu.au
DreamSurfer33 	eagle 	R.Schumacher@ugrad.unsw.edu.au
DreamThinker47 	michelle 	L.Horna@ugrad.unsw.edu.au
DreamThinker57 	rangers 	JK.Rowling@ugrad.unsw.edu.au
DreamTiger53 	diamond 	R.Redford@ugrad.unsw.edu.au
DreamTiger55 	batman 	H.Hunter@ugrad.unsw.edu.au
FunAngel69 	cowboy 	H.Clinton@ugrad.unsw.edu.au
FunAnimal12 	player 	J.C.Ferrero@ugrad.unsw.edu.au
FunAnimal61 	london 	T.McAuliffe@ugrad.unsw.edu.au
FunGeek59 	bonnie 	J.Timberlake@ugrad.unsw.edu.au
FunGeek73 	doggie 	Z.Zidane@ugrad.unsw.edu.au
FunGeek94 	jennifer 	R.Krajicek@ugrad.unsw.edu.au
FunGenius76 	swimming 	J.Travolta@ugrad.unsw.edu.au
FunGenius92 	warrior 	M.Richt@ugrad.unsw.edu.au
FunGirl32 	einstein 	C.Kennedy@ugrad.unsw.edu.au
FunKitten52 	rangers 	C.D.Johnson@ugrad.unsw.edu.au
FunMan15 	newyork 	C.Farrell@ugrad.unsw.edu.au
FunNerd71 	angels 	C.Electra@ugrad.unsw.edu.au
FunNinja44 	hardcore 	S.Lavin@ugrad.unsw.edu.au
FunnyAngel23 	beach 	A.Bassett@ugrad.unsw.edu.au
FunnyBoy48 	6666 	S.Shalom@ugrad.unsw.edu.au
FunnyChick24 	tennis 	Madonna@ugrad.unsw.edu.au
FunnyGeek59 	zxcvbn 	H.Dean@ugrad.unsw.edu.au
FunnyGeek93 	midnight 	K.Davis@ugrad.unsw.edu.au
FunnyGirl71 	dolphins 	J.Tymoshenko@ugrad.unsw.edu.au
FunnyGuy58 	booger 	M.Verkerk@ugrad.unsw.edu.au
FunnyPrincess73 	michelle 	T.Braxton@ugrad.unsw.edu.au
FunnyStar42 	ferrari 	K.Harman@ugrad.unsw.edu.au
FunnyStar88 	blue 	Q.Beatrix@ugrad.unsw.edu.au
FunnyThinker50 	welcome 	L.Ali@ugrad.unsw.edu.au
FunnyTiger16 	bonnie 	P.Srichaphan@ugrad.unsw.edu.au
FunnyTiger46 	white 	S.Blatter@ugrad.unsw.edu.au
FunnyTiger70 	robert 	Carrie-A.Moss@ugrad.unsw.edu.au
FunPuppy23 	biteme 	J.Rogge@ugrad.unsw.edu.au
FunPuppy79 	gunner 	A.Roddick@ugrad.unsw.edu.au
FunStar20 	boston 	C.Heston@ugrad.unsw.edu.au
FunStar23 	victor 	K.Clarkson@ugrad.unsw.edu.au
FunStar93 	tigers 	A.Calleri@ugrad.unsw.edu.au
FunTiger38 	firebird 	K.Costner@ugrad.unsw.edu.au
GeekGirl42 	hogwarts4ever 	E.Watson@ugrad.unsw.edu.au
HappyBoy73 	thunder 	L.DiCaprio@ugrad.unsw.edu.au
HappyBoy76 	777777 	R.Bonner@ugrad.unsw.edu.au
HappyChick41 	rebecca 	S.Loren@ugrad.unsw.edu.au
HappyGal45 	forever 	G.Hawn@ugrad.unsw.edu.au
HappyGenius24 	biteme 	M.Abbas@ugrad.unsw.edu.au
HappyGenius58 	iwantu 	S.Peterson@ugrad.unsw.edu.au
HappyGenius70 	phoenix 	C.Fiorina@ugrad.unsw.edu.au
HappyMan42 	doctor 	F.Fischler@ugrad.unsw.edu.au
HappyPrincess47 	tigers 	H.Berry@ugrad.unsw.edu.au
HappyStar82 	chevy 	R.Witherspoon@ugrad.unsw.edu.au
HotAngel63 	golden 	G.M.Arroyo@ugrad.unsw.edu.au
HotBadboy46 	london 	B.Assad@ugrad.unsw.edu.au
HotGenius59 	cool 	E.R.Wood@ugrad.unsw.edu.au
HotKitten19 	august 	M.Carey@ugrad.unsw.edu.au
HotKitten58 	madison 	A.Jolie@ugrad.unsw.edu.au
HotLover34 	peaches 	Mary-K.Olsen@ugrad.unsw.edu.au
HotLover59 	asdf 	J.Tapia@ugrad.unsw.edu.au
HotNinja77 	success 	A.Costa@ugrad.unsw.edu.au
HotNinja86 	smokey 	V.Fox@ugrad.unsw.edu.au
HotPrincess62 	gunner 	J.Connelly@ugrad.unsw.edu.au
HotThinker21 	ginger 	G.W.Bush@ugrad.unsw.edu.au
HotTiger81 	hockey 	C.Flockhart@ugrad.unsw.edu.au
NerdyAngel47 	fishing 	M.Kwan@ugrad.unsw.edu.au
NerdyDude15 	spider 	P.Burrell@ugrad.unsw.edu.au
NerdyDude54 	smokey 	I.Ramon@ugrad.unsw.edu.au
NerdyGeek14 	enjoy 	C.Blanchett@ugrad.unsw.edu.au
NerdyGenius52 	player 	R.Barr@ugrad.unsw.edu.au
NerdyGenius81 	jason 	A.Fraga@ugrad.unsw.edu.au
NerdyKitten92 	ford 	S.Graf@ugrad.unsw.edu.au
NerdyLover44 	raiders 	M.Bloomberg@ugrad.unsw.edu.au
NerdyLover69 	wilson 	H.Mills@ugrad.unsw.edu.au
NerdyNerd62 	captain 	J.I.Chela@ugrad.unsw.edu.au
NerdyNerd84 	enter 	G.Trevi@ugrad.unsw.edu.au
NerdyStar41 	daniel 	T.Shalhoub@ugrad.unsw.edu.au
NerdyStar68 	brandon 	A.Kournikova@ugrad.unsw.edu.au
NerdySurfer51 	shaved 	Z.Djindjic@ugrad.unsw.edu.au
NerdySurfer69 	victor 	J.McGreevey@ugrad.unsw.edu.au
NerdyThinker37 	voyager 	D.Jeter@ugrad.unsw.edu.au
NerdyThinker87 	ferrari 	M.Lewinsky@ugrad.unsw.edu.au
PrettyBadboy55 	firebird 	G.Popovich@ugrad.unsw.edu.au
PrettyBadboy58 	diamond 	P.Wolfowitz@ugrad.unsw.edu.au
PrettyChick60 	lauren 	V.Incontrada@ugrad.unsw.edu.au
PrettyGeek17 	pepper 	J.Novak@ugrad.unsw.edu.au
PrettyGirl40 	morgan 	A.Huffington@ugrad.unsw.edu.au
PrettyGuy19 	cool 	H.Ledger@ugrad.unsw.edu.au
PrettyGuy60 	maddog 	J.Williams@ugrad.unsw.edu.au
PrettyLover98 	donald 	M.L.Ramirez@ugrad.unsw.edu.au
PrettyNerd16 	michael 	A.Campbell@ugrad.unsw.edu.au
PrettyPrincess76 	slayer 	J.Foster@ugrad.unsw.edu.au
PrettyPuppy16 	junior 	D.Clark@ugrad.unsw.edu.au
PrettyStar14 	iceman 	J.Canseco@ugrad.unsw.edu.au
PrettyStar54 	scorpion 	N.Baye@ugrad.unsw.edu.au
PrettyTiger22 	4321 	T.Thompson@ugrad.unsw.edu.au
PrettyTiger53 	gators 	C.Diaz@ugrad.unsw.edu.au
PrettyTiger89 	mother 	M.Perry@ugrad.unsw.edu.au
RomanticBadboy53 	saturn 	R.Lowe@ugrad.unsw.edu.au
RomanticBadboy80 	12345 	L.I.L.da.Silva@ugrad.unsw.edu.au
RomanticBadboy88 	hotdog 	T.Daschle@ugrad.unsw.edu.au
RomanticDude47 	junior 	S.Spielberg@ugrad.unsw.edu.au
RomanticGeek10 	matt 	D.Fuentes@ugrad.unsw.edu.au
RomanticGeek64 	jackie 	A.H.M.Al-Tikriti@ugrad.unsw.edu.au
RomanticGenius60 	bill 	M.Salas@ugrad.unsw.edu.au
RomanticKitten20 	ginger 	L.Linney@ugrad.unsw.edu.au
RomanticKitten50 	asdf 	S.Kirkland@ugrad.unsw.edu.au
RomanticLover53 	rock 	I.Ajouri@ugrad.unsw.edu.au
RomanticLover76 	juice 	J.M.Aznar@ugrad.unsw.edu.au
RomanticMan73 	ladies 	M.Chang@ugrad.unsw.edu.au
RomanticNerd97 	george 	A.Peirsol@ugrad.unsw.edu.au
RomanticNinja69 	starwars 	T.Bennett@ugrad.unsw.edu.au
RomanticSurfer17 	hockey 	M.Gottfried@ugrad.unsw.edu.au
RomanticSurfer27 	qwertyui 	GL.Peiris@ugrad.unsw.edu.au
RomanticThinker33 	1234567 	W.Ryder@ugrad.unsw.edu.au
RomanticThinker50 	voyager 	R.Perry@ugrad.unsw.edu.au
SadAngel30 	paul 	M.Stewart@ugrad.unsw.edu.au
SadAnimal27 	silver 	E.Ginobili@ugrad.unsw.edu.au
SadAnimal80 	women 	P.Pettigrew@ugrad.unsw.edu.au
SadBaby64 	joseph 	P.Caroline@ugrad.unsw.edu.au
SadBaby75 	racing 	S.Osbourne@ugrad.unsw.edu.au
SadBoy26 	kevin 	H.Ford@ugrad.unsw.edu.au
SadChick30 	dolphin 	S.Calderon@ugrad.unsw.edu.au
SadDude80 	golf 	L.Neeson@ugrad.unsw.edu.au
SadGirl73 	college 	S.Stone@ugrad.unsw.edu.au
SadLover46 	jeremy 	G.Schroeder@ugrad.unsw.edu.au
SadLover82 	giants 	J.P.Montoya@ugrad.unsw.edu.au
SadLover89 	football 	N.McElhone@ugrad.unsw.edu.au
SadNinja30 	thomas 	T.Stewart@ugrad.unsw.edu.au
SadPrincess44 	theman 	B.Bhutto@ugrad.unsw.edu.au
SadPrincess83 	player 	N.Pelosi@ugrad.unsw.edu.au
SadPuppy65 	iloveyou 	C.Moya@ugrad.unsw.edu.au
SadPuppy82 	young 	N.Wyle@ugrad.unsw.edu.au
SadThinker53 	aaaaaa 	E.Dole@ugrad.unsw.edu.au
SadTiger22 	nicole 	E.Beart@ugrad.unsw.edu.au
SadWoman67 	fish 	C.Rice@ugrad.unsw.edu.au
SexyAnimal36 	chelsea 	A.Schwarzenegger@ugrad.unsw.edu.au
SexyAnimal79 	phoenix 	T.Cruise@ugrad.unsw.edu.au
SexyAnimal94 	michelle 	G.Canas@ugrad.unsw.edu.au
SexyBaby62 	travis 	N.Jones@ugrad.unsw.edu.au
SexyDude88 	jordan 	R.Zoellick@ugrad.unsw.edu.au
SexyGal66 	doctor 	S.Bullock@ugrad.unsw.edu.au
SexyGeek36 	1234 	N.Cole@ugrad.unsw.edu.au
SexyGuy83 	stupid 	R.Stewart@ugrad.unsw.edu.au
SexyLover21 	steelers 	F.Santoro@ugrad.unsw.edu.au
SexyPuppy17 	3333 	J.Laporta@ugrad.unsw.edu.au
SexyPuppy69 	enter 	S.McChrystal@ugrad.unsw.edu.au
SexyThinker12 	xxxxxxxx 	T.Blair@ugrad.unsw.edu.au
SexyWoman13 	golf 	M.Yeoh@ugrad.unsw.edu.au
SillyAngel83 	0 	M.Shriver@ugrad.unsw.edu.au
SillyBadboy18 	melissa 	P.Sampras@ugrad.unsw.edu.au
SillyBadboy54 	scooby 	R.Gere@ugrad.unsw.edu.au
SillyBoy18 	abgrtyu 	G.V.Sant@ugrad.unsw.edu.au
SillyDude15 	helpme 	J.Abizaid@ugrad.unsw.edu.au
SillyDude44 	orange 	H.Chavez@ugrad.unsw.edu.au
SillyGenius18 	phantom 	D.Pettit@ugrad.unsw.edu.au
SillyGenius28 	enter 	L.Hewitt@ugrad.unsw.edu.au
SillyLover42 	chicago 	D.Roberts@ugrad.unsw.edu.au
SillyLover95 	angela 	C.Palmer@ugrad.unsw.edu.au
SillyMan31 	dreams 	P.Carroll@ugrad.unsw.edu.au
SillyNerd30 	fishing 	R.Hunter@ugrad.unsw.edu.au
SillyNinja58 	lovers 	B.Howland@ugrad.unsw.edu.au
SillyPrincess31 	jeremy 	J.Garner@ugrad.unsw.edu.au
SillyStar35 	marine 	T.Franks@ugrad.unsw.edu.au
SillySurfer75 	nicole 	K.M.Bondevik@ugrad.unsw.edu.au
SillyTiger37 	pookie 	H.Duff@ugrad.unsw.edu.au
SillyWoman36 	boomer 	N.Maines@ugrad.unsw.edu.au
SmartBaby80 	lauren 	V.Redgrave@ugrad.unsw.edu.au
SmartBadboy55 	batman 	G.Papandreou@ugrad.unsw.edu.au
SmartGeek16 	sandra 	G.Lopez@ugrad.unsw.edu.au
SmartGirl30 	hotdog 	S.Hayek@ugrad.unsw.edu.au
SmartLover63 	secret 	M.Jackson@ugrad.unsw.edu.au
SmartStar59 	merlin 	O.Winfrey@ugrad.unsw.edu.au
SportyAngel29 	murphy 	E.Thompson@ugrad.unsw.edu.au
SportyBadboy90 	maggie 	T.Rupprath@ugrad.unsw.edu.au
SportyBoy27 	topgun 	N.Kirchner@ugrad.unsw.edu.au
SportyDude28 	232323 	T.OBrien@ugrad.unsw.edu.au
SportyGenius75 	dennis 	M.Youzhny@ugrad.unsw.edu.au
SportyGirl74 	0 	B.Wilson-Sampras@ugrad.unsw.edu.au
SportyKitten48 	ou812 	Q.Rania@ugrad.unsw.edu.au
SportyKitten92 	coffee 	M.R.Torrealba@ugrad.unsw.edu.au
SportyLover34 	scott 	A.al-Saadi@ugrad.unsw.edu.au
SportyLover42 	diablo 	R.Armitage@ugrad.unsw.edu.au
SportyNerd44 	test 	K.Hudson@ugrad.unsw.edu.au
SportyNinja14 	chris 	F.P.Roque@ugrad.unsw.edu.au
SportyPrincess63 	toyota 	G.Angelopoulos-Daskalaki@ugrad.unsw.edu.au
SportyPuppy75 	ferrari 	A.Toledo@ugrad.unsw.edu.au
SportyPuppy76 	leather 	M.Reichhold@ugrad.unsw.edu.au
SportyStar36 	victoria 	R.Kocharian@ugrad.unsw.edu.au
SportyStar55 	sexsex 	S.Frost@ugrad.unsw.edu.au
SportyStar58 	green 	F.Gonzalez@ugrad.unsw.edu.au
SportyStar60 	trouble 	C.Martinez@ugrad.unsw.edu.au
SportyThinker36 	qwerty 	Q.Latifah@ugrad.unsw.edu.au
SportyThinker98 	james 	B.Walters@ugrad.unsw.edu.au
SportyTiger70 	walter 	S.J.Parker@ugrad.unsw.edu.au
StrongChick66 	peaches 	C.Danes@ugrad.unsw.edu.au
StrongDude96 	gemini 	S.Abraham@ugrad.unsw.edu.au
StrongGeek91 	secret 	K.Raikkonen@ugrad.unsw.edu.au
StrongGuy59 	joseph 	L.Miller@ugrad.unsw.edu.au
StrongLover51 	123123 	V.Beckham@ugrad.unsw.edu.au
StrongLover62 	butthead 	C.Gregoire@ugrad.unsw.edu.au
StrongMan30 	tigers 	Y.Yakis@ugrad.unsw.edu.au
StrongNinja68 	0 	J.Biden@ugrad.unsw.edu.au
StrongPuppy94 	peanut 	B.Affleck@ugrad.unsw.edu.au
StrongStar93 	fire 	O.Osbourne@ugrad.unsw.edu.au
StrongThinker19 	bronco 	B.Frist@ugrad.unsw.edu.au
StrongThinker23 	bronco 	C.Bergen@ugrad.unsw.edu.au
TenderBoy10 	tiger 	J.Tressel@ugrad.unsw.edu.au
TenderGenius14 	purple 	T.Henman@ugrad.unsw.edu.au
TenderGenius32 	charlie 	R.Dinse@ugrad.unsw.edu.au
TenderGenius74 	skippy 	R.Giuliani@ugrad.unsw.edu.au
TenderGuy91 	flyers 	J.Harris@ugrad.unsw.edu.au
TenderKitten72 	cheese 	L.Liu@ugrad.unsw.edu.au
TenderMan52 	12345678 	A.Agassi@ugrad.unsw.edu.au
TenderNerd14 	chevy 	S.Hughes@ugrad.unsw.edu.au
TenderNinja31 	4444 	A.Zakayev@ugrad.unsw.edu.au
TenderNinja39 	sydney 	J.Wolfensohn@ugrad.unsw.edu.au
TenderNinja74 	walter 	P.Sarbanes@ugrad.unsw.edu.au
TenderPuppy23 	5555 	M.Khatami@ugrad.unsw.edu.au
TenderPuppy60 	heather 	V.Putin@ugrad.unsw.edu.au
TenderStar19 	junior 	G.Brown@ugrad.unsw.edu.au
TenderSurfer51 	brazil 	M.Winterbottom@ugrad.unsw.edu.au
TenderTiger24 	computer 	B.Ahern@ugrad.unsw.edu.au
